111111111111111111111111
100000000000000000000001
100000001111111000000001
100000000000000000000001
100111110000000111111111
100100010000000100000001
100100010000000000000001
100110110000000111111111
100000000000000000000001
100000000000000000000001
100111110000011111111111
100100010000000000000001
100100010000011111110001
100110010000000000010001
100000000000000000010001
100000000000011111110001
100011110000000000000001
100000010000000000000001
100000010000000000000001
100000010000011111111111
100000010000000000000001
100000010000000000000001
100000010000000100000001
100000010000000100000001
100000010000000100000001
100000010000000100000001
100000010000000100000001
100000010000000100000001
111111111111111111111111
