111111111111111111111111
100000000000000000000001
100000000000000000000001
100000000000000111110001
100111110000000000010001
100100010000000000010001
100100010000000000000001
100110110000000000000111
100000000000000000000001
100000000000000000000001
100000000000000000000001
100000000000000000000001
100000000000000000000001
100000000000000000000001
100000000000000000000001
100000000000011110000001
100000000000000010000001
100000000000000010000001
100000000000000010000001
100000000000011110000001
100000000000000000000001
100000000000000000000001
100000000000000000000001
111111111111111111111111
